EWEEWEEEEE
EEWEWEEEEE
EEWEEWEEEE
EEWEWEEAEE
EEWEEWEEEE
EEWEEEWEEE
EEEWEEEEEE
EWEWEEEEEE
EEEEWEEEEE
DEEWEEEEEE