EWEEEEEEEE
EEEEEEEEEE
EEWEEEEEEE
EEWEEEEAEE
EEWEEEEEEE
EEWEEEEEEE
EEEWEEEEEE
EWEWEEEEEE
EEEEWEEEEE
DEEWEEEEEE