EWEEWEEEEEE
EEWEWEEEEEE
EEWEEWEEEEE
EEWEWEEAEEE
EEWEEWEEEEE
EEWEEEWEEEE
EEEWEEEEEEE
EWEWEEEEEEE
EEEEWEEEEEE
DEEWEEEEEEE