EWEEWEEEEEEWEEWEEEWW
EEWEWEEEEEEEWEWEEEWW
EEWEEWEEEEEEWEEWEEWW
EEWEWEEEEEEEWEWEEEWW
EEWEEWEEEEEEWEEWEEWW
EEWEEEWEEEEEWEEEWEWW
EEEWEEEEEEEEEWEEEEWW
EWEWEEEEEEEWEWEEEEWW
EEEEWEEEEEEEEEWEEEEE
DEEWEEEEEEEEEWEEEEWW
EWEEWEEEEEEWEEWEEEWW
EEWEWEEEEEEEWEWEEEWW
EEWEEWEEEEEEWEEWEEWW
EEWEWEEEEEEEWEWEEAWW
EEWEEWEEEEEEWEEWEEWW
EEWEEEWEEEEEWEEEWEWW
EEEWEEEEEEEEEWEEEEWW
EWEWEEEEEEEWEWEEEEWW
EEEEEWEEEEEEWEEWEEWW
EEWEWEEEEEEEWEWEEEWW