EWEEWEEEEEEWEEWEEE
EEWEWEEEEEEEWEWEEE
EEWEEWEEEEEEWEEWEE
EEWEWEEEEEEEWEWEEE
EEWEEWEEEEEEWEEWEE
EEWEEEWEEEEEWEEEWE
EEEWEEEEEEEEEWEEEE
EWEWEEEEEEEWEWEEEE
EEEEWEEEEEEEEEWEEE
DEEWEEEEEEEEEWEEEE
EWEEWEEEEEEWEEWEEE
EEWEWEEEEEEEWEWEEE
EEWEEWEEEEEEWEEWEE
EEWEWEEEEEEEWEWEEA
EEWEEWEEEEEEWEEWEE
EEWEEEWEEEEEWEEEWE
EEEWEEEEEEEEEWEEEE
EWEWEEEEEEEWEWEEEE