EEEEEEEEEEEEEEE
EEEEWWEEWEWEEEE
EEEEEEWWEEWWWWE
EWEEEEWWWWEEEEE
EEEWWEWEEWEEEEE
EWEEWWEEEEEDEWE
EEEEEWWEEEEEEEE
EWWWEWEEEWEEWWE
EEEWEEWWWWEWWEE
EEEEEWEEEWWEEWW
EEEEAEEWEEWWWEE
EEEEEEEWEEEEWWE
EEEEEEWEWEWEEEE
EEEEEEWEEEEEEEE
EEEEEEEEEEEEEEE