EEEEEEEEEEEEEEWEEEEEEWEEEEEEEEEEEEEEEEEE
EEEEEEEEEEEEEWEEEEEEWEEEEEEEEEEEEEEEEEEE
EEEEEEEEWEEWEWEEEEEEWEEEEEEEEEEEEEEEEEEE
EEEEEEEEWEEWWEEEWEEEWWEEEEEEEEEEEEEEEEEE
EEEEEEEEEWEEWEEEEWEEEEWEEEEEEEEEEEEEEEEE
EEEEEEDEEWEEWEEEEWEEEEWEEEEEEEEEEEEEEAEE
EEEEEEEEEWEEEEEEEEWEEEEWEEEEEEEEEEEEEEEE
EEEEEEEEWEEEEEEEEWEEEEEWEEEEEEEEEEEEEEEE
EEEEEEEEWEEEEEEEEWEEEEEEWEEEWEEEEEEEEEEE
EEEEEEEEWEEEEEEEWEEEEEEWEEEWEEEEEEEEEEEE
EEEEEEEEEWEEEEEEWEEEEEEEWEEWEEEEEEEEEEEE
EEEEEEEEEWEEEEEEWEEEEEEWEEEWEEEEEEEEEEEE
EEEEEEEEEEEEEEEEWEEEEEEEWEEWEWEEEEEEEEEE
EEEEEEEEEEEEEEEWEEEEEEEEWEWWEWWWWWWWWWWW
EEEEEEEEEEEEEEEWEEEEEEEEEWWEWEEEEEEEEEEE
EEEEEEEEEEEEEEWEEEEEEEEEEWEEWEEEEEEEEEEE
EEEEEEEEEEEEEWWEEEEEEEWEEEWEEWEEEEEEEEEE
EEEEEEEEEEEWWEEEEEEEEEWEEWEEEWEEEEEEEEEE
EEEEEEEEEEWWEEEEEEEEEEEWWWEEEEWEEEEEEEEE
EEEEEWWWWWEWEEEEEEEEEEEWEEEEEEWWEEEEEEEE
EEEEEEEEEEEEWEEEEEEEWWWWEEEEEEEEWWWWWEWW
EEEEEEEEEEEEWEEEEEEEWEEEEEEEEEEEEEEEEEEE
EEEEEEEEEEEEEWEEEEEEEWEEEEEEEEEEEEEEEEEE
EEEEEEEEEEEEEWEEEEEEEWEEEEEEEEEEEEEEEEEE
EEEEEEEEEEEEEEWEEEEEEEWEEEEEEEEEEEEEEEEE
EEEEEEEEEEEEEEWEEEEEEEWEEEEEEEEEEEEEEEEE
EEEEEEEEEEEEEEEWEEEEEEEWEEEEEEEEEEEEEEEE
EEEEEEEEEEEEEEEWEEEEEEEWEEEEEEEEEEEEEEEE
EEEEEEEEEEEEEEEEWEEEEEEEEEEEEEEEEEEEEEEE
EEEEEEEEEEEEEEEEWWEEEEEEEEEEEEEEEEEEEEEE
EEEEEEEEEEEEEEEEEEWEEEEEEEEEEEEEEEEEEEEE
EEEEEEEEEEEEEEEEEEEEEEEEEEEEEEEEEEEEEEEE
EEEEEEEEEEEEEEEEEEEEEEEEEEEEEEEEEEEEEEEE
EEEEEEEEEEEEEEEEEEEEEEEEEEEEEEEEEEEEEEEE
EEEEEEEEEEEEEEEEEEEEEEEEEEEEEEEEEEEEEEEE
EEEEEEEEEEEEEEEEEEEEEEEEEEEEEEEEEEEEEEEE
EEEEEEEEEEEEEEEEEEEEEEEEEEEEEEEEEEEEEEEE
EEEEEEEEEEEEEEEEEEEEEEEEEEEEEEEEEEEEEEEE
EEEEEEEEEEEEEEEEEEEEEEEEEEEEEEEEEEEEEEEE
EEEEEEEEEEEEEEEEEEEEEEEEEEEEEEEEEEEEEEEE