EWEEWEEEEEEWEEWEEEEE
EEWEWEEEEEEEWEWEEEEE
EEWEEWEEEEEEWEEWEEEE
EEWEWEEEEEEEWEWEEEEE
EEWEEWEEEEEEWEEWEEEE
EEWEEEWEEEEEWEEEWEEE
EEEWEEEEEEEEEWEEEEEE
EWEWEEEEEEEWEWEEEEEE
EEEEWEEEEEEEEEWEEEEE
DEEWEEEEEEEEEWEEEEEE
EWEEWEEEEEEWEEWEEEEE
EEWEWEEEEEEEWEWEEEEE
EEWEEWEEEEEEWEEWEEEE
EEWEWEEEEEEEWEWEEAEE
EEWEEWEEEEEEWEEWEEEE
EEWEEEWEEEEEWEEEWEEE
EEEWEEEEEEEEEWEEEEEE
EWEWEEEEEEEWEWEEEEEE
EEEEWEEEEEEEEEWEEEEE
WEEWEEEEEEEEEWEEEEEE