EWEEWEEEEEEE
EEWEWEEEEEEE
EEWEEWEEEEEE
EEWEWEEEEEEE
EEWEEWEEEEEE
EEWEEEWEEEEE
EEEWEEEEEEEE
EWEWEEEEEEEE
EEEEWEEEEEAE
DEEWEEEEEEEE
WWWWWWWWWWWW
WWWWWWWWWWWW