EEEEEEEEEE
EEEEEEEEEE
EEEEEEEEEE
EEEWEEEAEE
EEEEWEEEEE
EEEEWEEEEE
DEEEEEEEEE
EEEEEEEEEE
EEEEEEEEEE
EEEEEEEEEE