AEWEEEEEEE
EEEEWEEEEE
EWWEWEEEEE
WEEWEEEEEE
WEEWEEEEEE
EEWEEEEEEE
EEWEEEEEEE
EWEEEEDEEE
EEEEEEEEEE
EEEEEEEEEE