EEEEEEEEEEEEEEEEEE
EEEEEWEEEEEEEEEEEE
EEEEEEWEEEEEEEEEAE
EEEEEEWEEEEEEEEEEE
EEEEEEEWEEEEEEEEEE
EEEEEEEWEEEEEEEEEE
EEEEEEEEWEEEEEEEEE
EEEEEEEEWEEEEEEEEE
EEEEEEEEEWEEEEEEEE
EEEEEEEEEWWWWWWEEE
EEEWEEEEEEWEEEEEEE
EEWEEEEEEEEEEEEEEE
EEEWEEEEEEEEEEEEEE
EEEWEEEEEEEEEEEEEE
EDEEWEEEEEEEEEEEEE
EEEEWEEEEEEEEEEEEE
EEEEEEEEEEEEEEEEEE
EEEEEEEEEEEEEEEEEE